┌----------------------------┐
|                            |
|                            |
|                            |
|        #          #        |
|        #          #        |
|                            |
|                            |
|                            |
|       #            #       |
|        #          #        |
|         ##########         |
|                            |
|                            |
└----------------------------┘
INFO
size 30 15
start 3 2
solid ┌ ┐ └ ┘ - |