█████████████▌ ▐█████████████
█                           █
█                           █
█                           █
█                           █
█                           █
█                           █
█                           █
█                           █
█                           █
█                           █
█                           █
█                           █
█ BOTTOM                    █
█████████████████████████████