█████████████████████████████
█                           █
█                           █
█                           █
█                           █
█                           █
█                           █
█                            
█                           █
█                           █
█                           █
█                           █
█                           █
█ LEFT                      █
█████████████████████████████