█████████████▌ ▐█████████████
█                           █
█                           █
█                           █
█                           █
█                           █
█                           █
                             
█                           █
█                           █
█                           █
█                           █
█                           █
█ MIDDLE                    █
█████████████▌ ▐█████████████