█████████████████████████████
█                           █
█                           █
█                           █
█                           █
█                           █
█                           █
█                           █
█                           █
█                           █
█                           █
█                           █
█                           █
█ TOP                       █
█████████████▌ ▐█████████████