█████████████████████████████
█                           █
█                           █
█                           █
█                           █
█                           █
█                           █
                            █
█                           █
█                           █
█                           █
█                           █
█                           █
█ RIGHT                     █
█████████████████████████████